................
###..###...#@#.@
##@..##@...@@///
///..///...,-,-,
@@@@@@@@...#####
////////...,,,,,
...........-----
....%...........