........
####@@#@
../#....
--------
,,,,,,,,
...%....