###........@@..
.....#########@@
###..,,,@@@,,,..
///.....,,,...//
......###.....##
@@@@@@@@@@@@@@@@
////////////////
.......%........