................
################
@@@@@@@@@@@@@@@@
////////////////
,@,@,@,@,@,@,@,@
#/#/#/#/#/#/#/#/
................
......%.........