.................
#@#@#@#@#@#@#@#@#
/,/,/,/,//,/,/,/,
,#,#,#,#,#,#,#,#,
@/@/@/@/@/@/@/@/@
.................
.................
........%........